13,41
119,4
58,107
92,25
150,97
15,85
91,96
117,103
39,109
65,63
110a11111111111111101111011101111111011011111111111111111101122112210120211120121121101212212202221a12212012122200102021101101111111111111111011a101011010110101
011a11111100111011111111111111001110101111111111111111101111111220222102200012212121120101202122120b20102222201102221121221111110011011100110010a111011100101111
111a01111111111110110111101110110111111111100111100110101010112101202011121221112120102210102202010a01120201100022221202221111011000110111001101a111101111011111
101a01001011111111111001111111111011111111111011011111111110122222111222010001101022202211221111022a12220212221001021222000111111011111111011011a101011111111011
101a11110111111011111111011110010111111011101110011010111001112202110111211201102211220122210111120b00212202122111121122122111111011111001111111a011111110111011
111a11101111110101011100111111101011000110101111011011011111102112221121101111102120120212201120201b10122100011222021110102100111011011111110111a110010111011111
111a11111111111111110111011111101011011101111011011111011111112210211102212010221121121121111000012b11212122200211212221212111101101110111110011a110111111100111
111a11110100111111111111101011111011101111001111111111111011101101222021212202010002110102121102201a20222221121202122112021111111111111111011111a100011111100010
111a01111101111100001011111111111111100111111111111110010111112000120021012220120002211011222010112a22111122122121112121201010111011010011111111a000111111011110
111a11100011111111111111111101010110111010101111101010111111112222022102202021010222121020211220222a22221112211121111011222111101101111111111110a011111111100111
110a01011011110100111111111110101101111101101111100110111101122010102022112021220222121210100221220b21221121102020022012122111110111111111110001a011111111111010
011a10101110111001101011110110111111000111111110111111111101102221212112102211211120221121122120101b01110120222012121122022111111111101111111011a011111100111100
111a11111111111110101110111101111011111111111110101110111101011212112021102111011100121121010221022a20212212202021210102111111111111111111111011a111101111011011
111a11111111111111110111111111111011011111110111110110110111021222212222211210121020221012222121110a01122110111110022110212111111111111101011100a111111101100111
111a11011111111111111111111101111111111001110111011111111001100101212222121102111210121112111012220b20121111110212211221122111001011001111110111a111011110111111
111a11111111110011111111101111101111001111110101011111010111101011111222112110101202202222111212221a11222122111122221201101111111111101110111111a111111011011101
111a10111011111010111111111111111001111110111101101111111111121002212222211022212111212212210222001a22102211120002111011221110101110111111111111a111101101111111
110a11110001011101101011111111110111111111011110101110101011002120122022102222221112101211112010112a10111111022200201001022000111011110001001111a110111110111011
111a00110100011011111001010001101010011111111111111111100111111011110222212112211111010121112012110a00112002100211111121101111101101101101111110a001111101101110
111a11111101111111111110011110111101111111101010011010111110111122211222010202122102122201211201121a01111212012211011211012011110001110101111111a111111111110101
011a11001111111111010111111100111101011011111111111011101111002110212220221022222112021120122121200a22122101211120200212011111101111011011011101a111110111011111
111a01101111111101111111111000101111111111111111011111111111001122210012210021101011210212111202211b11121221121121222120101111011111111110111111a111110111110100
101a01111111011110011010111011111111111111110111010101001111121120100211121121111012112111212100111a11211021012102121222221111111111011111111110a111111101111101
111a11111011101110011111111101101001110101111010111111011110120012221201110102010012212122010021122a22211011101221110022011101111111111101110110a011111111111111
110a00011111111011001101111111011110011111111111101111101111112212220220222212010021221121010002001b11022212222202020112011111111100010111111111a111101101011111
010a11110101111111111111111111111010111101111101111111111101122102211110112111201101101202212210121a22202222210022220102012001111111111011110111a010101111011101
111a11011111111110111010111111111111111111001101011011111000021222221222210202122201111021222202221a01112121011202111222100111011110111111111011a001001110010011
110a11111111011011111111011111111011101111111011111111111111120211101221220122012111211111001222100b11111111211012002012210111000111111011111101a010111010100111
011a11111110111011110111111101010101101010011111111111111011122211101012002012020122222101121001211b21021220211020221121212010101111111101111111a101111111111111
111a11111111110111111110100111110011101111111010111110111101122021211221111211212120111110220102211a22111112212220120120121110111100111111101111a110111111101011
101a11110011011101011110111111111101111111111111000111011111111102200022011201120211222202202122202a12120221121211121222002111111111111101111111a001110111111111
111a10111011111111001111111111011111111001111110100111110111121220021221121111211010011101222211211a22201000111102121222120011111110111110011111a011111101111011
111a11111111011110111010111110110110112212002112202112111200200222222222202212211022012022220102022b02210111202110222222202111011110101111011111a011101111110111
111a11010011001011111110101111111120110202012101110120222201112212222212022221212020222220220202121a22022011201202211120221001110110111011111111a001011001111111
101a11111011111101111111111111101002122120212222100212012221202022022022001212212022112221222220220b11010102112021222121211101111111110111110111a111111111111111
111a11111111011110001011111111111121110111112201111200221210022222222222022200212022221020020201212a12211021121200112111001111101011011101100111a111111110111101
110a11010101101111111101111101111122111011112212122122111100221002220222221222010222221120102012220a22001211011112112221111111011011101111111011a111011111100010
101a01101111111101010100100011111110022222111102101112121221002022002212221212200002222020202221121b02222122022121012111221011111111101001111110a111011101111111
111a11101110111111110111111111111112210121000101202121111020002002022020110220212022020212210121120b22101222122212220220012111001110110111011111a100111111101111
111a11111111111011011001111011111100002010121102201201211212020202102222112222202222221111202220210a11122120111221211121220110000111111111111010a111111111101010
111a11111111111010111111101011111111100201121000122120220002020022220222222022120222202121222221200b12222022211212120010112101101010011111111100a111111011011111
111a01110111111111111111011011101110111011211022021121222220021021220020222122221122022202221222122b22121201010212122022112110111101111111110011a111111111110111
101a11101010110111111101111111110111102111100001221111022022021102222200122202010222211002022012101a00010122111022021021122011111011101111111110a011101011000101
101a01011111111100000111010111101122120201211111201121212022101111212122212222212002222222220001222a21202122021112220202211101110111101100101011a101101010101101
101a11110111111101111111111111101121121112202001212121222121002222222012022222201110222020210200121a21221002112211222120201111011101011011110111a111110111110111
101a11111011101011101111101101111121221220102012222100221112222112201112222212122222212222200222112b21210010101010110222200001110110111101110011a100111101111111
111a11111111110111011111111111111111022110122110110211211111210122222222210221120112222000220012011a10221201010202101201221101111111011111111111a101110101011111
111a11100000101111011110101110010011101122012222102212110221120220212220220222222210220212022212110b20012222110222111210221110110111011111011100a111001001110101
010a11110101011101100110110101100112002111121222121212212002222022020221222222222212222222122220002a21011112211221211222201111011110011101101111a111101111010111
110a10101001100111111011111111001121011121011200010100121111122222212112220110210110210120022212221a22221202112112100112222011111111011111111111a110111111010101
101a11111111100001001110111111100112021112122210121001220121021222122202222112222022212222021222222b21110212210121211112101111111110111110101111a101111111111111
111a01101110111111101110011111111122222022012122011110022122100122210222022100220022020012220002122b12111120012201220200110101101100111111110101a111111101111111
100a11111111011111111010101110110120121212122222210021212021122022221220012222122122102202021202010a12021021121111200202212101011111110111110111a111111110110111
101a10001101111110011111111010110021202011122201222102222101101202102222222222220121222121212122122b01122221021122122121202111111111111111111101a111111111110110
022b12211211122110100111122111221222020102222100102211222120121022021121222212120021021022211220122b21222212211110222121121111110100110111100110a011111111111111
022b11202112121111221012011012221222202202222210021000002100022202120212212111202200220010121022010b01121201000211220212222111111111101110101010a111111101111011
212b00220110112200012210001012102022121221222112220212121212222111111021012002022221001122010221111a11111111101101011111111111111111110000101111a111100110110111
101b01202110222222221102121101001121222222122211022212211221002211202210102012120210222022101210011a11111110010111111110101110110111111010111011a110011100101110
221b21221010212201020122210000220201220222222100222101010222021212121102001212221211121012022122111a11111111111011111011111110110111111111111110a111100111011111
111a20222002120102102211002221121012202112212022101020220001202220002111220122220212222012202212111a01111111111011111101011111111111101111111111a101111111111011
122a22220020012002112221111211211122020222220222120221012100022120121002222112221220201111212221111aaaaaaaaaaaaaaaaaaaaaaaaaaaaaaaaaaaaaaaaa1110a111011111101111
202b111212210221221020111212121022212210222021210220210012020222211222110222221202100111222120211111111111111111011111011111111101100101011a1101a111111010010111
212b011102021120022121002221120010022222222200211112101021122211120121220101121121100200212222110011011111111111111111011110011111111001001a0110a111111111001111
121b000112012101111111200022220002202222102212122211012022201121122202102002210202121100110210121111101011110111111111111001111011111110101a0101a110110010111110
211b021220211011212201021100002111220022222112121120222221122010110220110011221212220200111202221111111011100111101111111111011111100110111a0100a111111100111111
122a102111010210010101201200122012021222122120212021211121111222120220022122212200020221102212222222012122220211112111001011011100111111111a1110a111011111111101
221a110221200120112210202201212101212121112220022122012111202210222211022220222202200222201200022212110212112220221211022222000011122002122a0001b011211122202120
102b202211111122222001212020022112022020220102021110111021111110211210220002222221221122222202011222102210011021212211121022120121121121211a0112a021210012220211
220a211211012212101210102021201112021022222111020021021222110201212201002200212010210222210022221010011221111220211221201010000122022210122b1012b200012101121121
221a101220110211221221012211021220111002011222221120111011222122222101022222222212212222222122000221121121020122120220022212222012211121221a1100a110112122212002
211a221101212011022011021202221011022222201222212111101201212221122202220122220002221122221022211111110210201121210222210102210120012210212b2021a110101011201021
111a110212211121011121201102220122110222222021002120110102022222011021202220222012021222002212100111012211111012111112202220111211121001001b1112a111210121212121
111a011211202201222000112122110012212222102111112011201010222201221112121121022212220222222200220202210200220120222122220110112021202022212b2102b221120201211012
212b200210112112101120220112112200201220222221010211101211022220212002011222222122202222122212222220021222221222212112200021221220221000222b2222b110021120111112
122a112201222102222211121121212210012121110222102021221122112122122222122220122212210122021122222220022100021110121122202220221200210022100b0202b222122102112111
111b012110220220212222202200201121002210202012121112221122112202112002222200021201222020120222022222200202011202120222222222121210212200222b2120b221100111221011
022b212011221112020220021002122212220222222022111112112221001222202222212220222222202202222012220221222120122222120121120210120122122022002a0222b221102201220212
102b120201021122002212021000121220202222222222022220012202022022201222222222210222202222022120022022102020212212211222022211022221102021222a2122b211122212111212
222b112012222221020220222221122202222220222022222222222222020022222202221222222222222222201120222222122222222222020202012020222222222122022a1222b202212211112222
210baaaabbbbababbbabbabbbbbbbabbbbbbabbbbbbbbbbbabbbbbbbbbbbbbbabbbbbbbbbabbbbbbbbbbbbbbbbbbbbbbbbbabbbbabaabbbbabbbbabbbbba210212010220221b2222b122121212220012
010101222200220221222221012221222220202220220220222222222222220222222222122112220222202022222022220121210202122212122212200a222222211111222b0011b110211222010111
110000212222211222220211202222222022222002000221002022222020211222020222222210222002022211220222202202122222222222212002222b220021122112022b2221b012101111222112
212001101020222122220222202000222221222220222220022222022020222222222222122222122222102022202222222222221222010222102121222b222122222221022b0022b211121212112111
110212211022012222222202222200122222022022222221222112222210222220222110222222222212012222220202121221121120201102122220222b220202022222211b2222a002121120210212
bbbaababbabbaabbbbbabaababbbbbbbabbbbbbbbbabbbbbbbbbbbbbbbbbbbbabbbbbbbbbbbbbaba2200212222222222202222220221221222122221201b221212011212020a2221b011212202011211
2120221022212222200221200212002022220202222220220202002202222222222002220222022a2212222220222001220022012001222000112202001b122122020010221b0222b222111211000202
2222111122222001122212021212222000222212220022022221002222022202220222201222022b0220200220122222012101122220212112210220222b021200020122222b2200a212122221022201
2111202201221222112121122200100222022202220222212211222222122022222222222222022b0202222222222221212222120122022220222122222b121201000000011a1222b222200212202200
1101011122220122201001022000222120022022221222200220202221011020202022222221220b2222202202202222222221222220112222021022221a122121102222111b2222a001112121121022
0211210122201222202122220200212212200221222022222011102202202222202222222222102b0211222222222220022220221122221210221020222b212102210222222b2220a022220120120021
1122002022222222122221002222222020220012222220022222122222220102201222222021220b0000210122202222112201202212112222012220002b222212220221121b2222b022211211211211
0112211120022022111220222222220212120222222220202202222022222222022222222220100b2202202220220122211111222102222202212202210b121222222021222b2222b202011121112021
1100202212122002021022201022202122022122112212220222222222222020212222120202120b2222220222212222200022212121002211012202221b211210202222220b0011b210221202221201
1111212220102102221222222121200222222202202220022212122202222012222200221221222b2222222020222221221122002220110021102212222a202222010222221a2202b122222012122211
0222202022101220122220222122221222022212222222001222200212222222210222222002221b0221102222222212201122211202101221210222200b012222222022012b2222b101222111121220
1011112122221012012220221102122212212202212222122202020222220222021212222121102b1120212221220221210121221122202122100222222b210012022021121b2220a020021222210212
2221010200112222201002022222221220200000020022212122002220202022002222221222120b2102110222202121121021212212112200021222222b000202200220222b2020b222002202002122
2022222111121020222020222220222212220222222200122011122212020221102020110211220b2211220220221212222222222222200021112102202b110202221220012b1220b222010112111222
1111211120000120212222202222220222222222220122202122002001222220122022202220020b2212002222021202222222221111220020221021021b211022221002211a2112b112202111202121
1011102020122202120220210222122202222022220002221221221221202222022222222221222b1111100222222222122211010210001121020200002b222102220221202b2121a220100112102012
2110211122200112021212222212022002022222222122212222222211202222220222222010121b1122222222212222211221211122220111222012122b102202212122202b0202b222211212122210
1100211200220211221220200200020220012212222022200220212120011221222220222222112b0022222220222221022210210011210020022102122b201212222222211a1222b220100102102110
1112212212120222122022222012222220222222222200211222212002022222020222222202221a2210222001122222200200010202202102200222222b121220202122222b2221a221101222201212
1222222220020212012212221020201222222222022220200202220222122212222222200202222b2202202221221212020122011002200220222222022b222222212200222b0220b120021110121212
2112211102022120220222202200210222200212222220202201022201002220121222211222121a2212122112210122222002021021101201222212222b221122000202020b2212a222111222111211
2212102222022102201211122202222012212221000222121211222222212201222222222201212b0011202202020120202222012202011012221002222b202222221222210b0221b122212220021121
2112100122222211022222220220202222212222222202202022222012022222222222222222101b1200222222220202222222222220202022222021202b222212122020222a2222b202200221201211
2201220000200222200222012222201222022220200022202222221002222220202220102201221b1220122000220222212222022202121122220221222b220111200202222b2211b000221122211210
2111201021122121102221012102022220022222001220222221112221212220222211222112021b1221122220212112212021202222022221002212222b220100220121222a2211a222002112212101
2222212112222022220121010001022222112222102202222222221120021022222222122022221b0222002222200202221012112012200011001022220a222111112221001b2100b112012102011111
2211111122022222202021122012220220220002202022022212101220220201022102220012002b1220212222021202122220012000220222122112202a220220001222220a2221b220210211100200
2102122021222022222102122221202222200122020222020212021212022220212220220022210b2212120222012122020000220012211222210212221b022112202220201b2222b102111102222121
1210222022210122000220122221200222202222222212222202022122212202222020200220222b2121011220022202222222222202012222122220220b202201220222222a0212b111021222221121
2121121222211220222220202121212022122002222022022222112120112222122212002002222b0222022221221022120202212221212221210020212b122102122221022b2200b211112211101010
1011222222202200101121221222022222221022021012221020000012222222222020012222221b1200212022202121020220210120211202112202221a220220221102220b1221b222101010210201
1221111202022222222022212211220122221002222122221222221222022022022122102220220b2022221222202012120102221122220222002022222b210121210121001b2200b021021201101100
1001001010122112111222011220022002222022221222112200102010012200222202022021121b2022022222212220212100211201211122010022221b120221222121211b2202b000021110210201
1101011121220110221001010211220000022222221212202010222001122022212022121210022b1002221221202102122222202021020000201200102a222221222102212b2212b201122010012010
1011101112110212211001112200220211221222212002200021222221222222222200212201212b2220221122222002212222220022212021222000100b001222222221202b2220b222222210021221
1111111010121001211111002111222122211222022221111221222220022122222222202220202b2221110220222222201022211210222220011221221a120000220121222b1222b012111201121121
