140,108
31,19
15,106
140,82
158,96
31,91
53,105
67,30
143,36
140,109
11101a1110111001101110011111011111112210210220001101112020211010202110221122121222112010212222022111111110101011111110111111011111101111111111011111111101111011
11111a1111111111111111111111111111110211220201112122012111211020220211021021200111021112212110101100101111111110101111111001111101101011111110110110111001111110
11111a1111110111111111111111111101012211110221201201120002221212222111022212111211100222201110122111110111111111010111110111111011111111111110101111010111111111
10111a1111101101110111011001001111110122121221100202121102112001121001011112202122122221110101011211101010011001111111011111011111111111010111001110111111110100
11111a0010111110111111111111011000111200010102101221121010221210121220202211010121222221100221121011111011001101101011111101111111001111111110111101111111111111
11100a1110110111000011110111101101111111211121221110112112001221122122112120211122210222222200111101111100100111201222010110021201001100121212221101012211201010
10111a1110110101111001101001101111111211121100221001122202101101201212221111122211111021222222201010100111111111212121001010002201212101210100012202211201201221
11111a1101101100101110011011101111102220122122022210221121112121121100110001020012102201102021221111110011101111211212212012221222212011221221222100122222211120
00110a1111111011010111111110011111112112102211011212101102222212100220211122221221211120102102201201101111111101222112111121211211211221211220122012212121112211
11010a1111011111100111111111001111111121220212221212121120121100211221212110001112110212112120211211111111111111112200222121212112122212011111201000112001111212
11111a1111111101010111101011001111112210112222202112200222110020000220110022222220221022222111202211011101110111221212120222122101201122211210212001221120212112
11111a1111111111100001111111110111100220120012122120210101010122100221222101002111022111222222210211111111111111211102210112011221012221212221111011122122022212
11101a1111111111111111111111111110011121001102210202022021111021221102210111120211112110111211110211111010111110012122111122102020100121102111222222101002100221
10111a1111100011111010111101111110100110221011220212212110112122112201122121220122220112021212221000111101011101121012100222101201002011202102222012221112210021
01100a0111111111010111001111011110011220210111001101222211020102121122110011110021121011221202101111111011101111121221112121212120222121122112221101202112111002
10101a1111101011111111111111111100112122112012220222210200200221202012212211221212212001202100211011111111111111222212201201020211102212111211112111211202220222
11110a1111011111111111101101111100112212012122100221112222221221221221211100111202201220211001221201111110110110020011021222220212011222110121010120011021112111
11011a1011111110111111110101110011111111122102101011211221120122212211121201211121211222211211101101001111110010212000211222220210211202121211012022110222212021
11111a1111111110110101111101011111101212201211212222022112220200220021111020222121122012021121120111111011001101222001120111202001011212211222011021212120012012
10111aaaaaaaaaaaaaaaaaaaaaaaaaaaaaaaaabaabbbabbbbbbaabbbababbbaababbbaaababaababbabbaabbbabbbaaaabaaaaaaaaaaaaaababbaaaaaabbbabbaaabbbaabbaaaabbaaaabbabbbaabbba
aaaaaaaaaaaaaaaaaaaaaaaaaaaaaaaaaaaaaabbaababbbbaabababbbabbabaaaababbaaaaabbabba1100120201110222111011111111111021212110100212012220212021110112112110211010011
11101111111111101111111111111111011020212011112121001211120121212211011202112222b1121010100200112211011001111111011011121011020121100221102110202212010100222122
11111111111111111011110111111111011012112101122002111211112121202011002222122010a1222211121012012210111110011111211002021002211122022012211112010111022122212200
11110111011111111011110111110111111012021111220012012201111220011012020201112112a0002102022001122011101111110111122011021201111211020221122212221100122000201112
11111111101111100111111011111111110111012202101020001001020201002010202121210101b0211222121102121211101101111101200120111211020221120220121212211212022211111221
11111101111111111111111101110111100110112001010122111210211122110210112102222121b2112211022220222211111110110111100110121021212202111122100112022212022010002111
11101111110111011111110111111101111112120222201220112111010112211111221222001221a1122110201212220211111111011111202012011021122200202202202201111112110112101011
10111100011110101111011111111111111120212211012121210111212202111212110121221122a1210202222122212211111111101110212002220221202221210022122211221102122101212221
11111111111111111110110101111111111122210222100122111201021021111221111112212211b1122222021202212211010111111111000201211112111111000101222021001002121120020220
10111101011111011111101111111101111121221021112012200012211222122212102202111120a0211222022111112101001111111111022202112211121120102210122122222001210210101121
10111101101011001111101111111101111101112220200120211222112222011121122201121221a1202120211111221210100010101111222111111022211221001100022211112111202111121101
00111101111110111111101110110111110112020111021020222021101001111222111112020211a1202200120221111211111110111111200011121211001122102221210022122222212120121122
11011111101111101111010111111111111122221121100122122200110011222221212011221022b2201211111122112010111111111011122001111120212202122210021112110201122202202102
11111111111111101110100100111111100101221202121111021211110112022222121200112220a1222122012212112211111111111111222102111121211112002122111111120010022212212210
01111000011111011110011001111111111112222221221012121211110221011111122012220012a2111112111012112211101110111111112022010200211212101021112211221002112002211012
11000111111111111011110111111111111110121011112100121201022100221202110002121012a2121221210121022011010001111101111020001121212002100102111211000222112222111121
10010111101011101101111111110111111102112102222212112220102100110100121122220220a2100222122110222111101111111110101022011120020112211202122221221020122010221201
11010111111111111111010011111001100101201220212122022120222121002221221121201101b1101220220222022211111011111111210212111121211122120202122121100221221210202111
10111011111001111110101111100111111112211210112012202211220122101121120222211110b0211020110111121011111111111101212121220021110120121111212222212112120220111010
10111011111111110110111101111101111120202112122221002221001202111020120022122110b1211211222111112101111111111110202012110210111111210122222111100111111111221211
11111111011010011111111111111101111120112121212220011202002012012122221112110122abbaaabababaaabbaaaaaaaaaaaaaaaababababbbbababbbbaaaaababbaabaababbbbabaaabababb
0111111111111110101100110111110011112120021110201201121110222110022011222120120211211201121021210210111011001011201022221102201121211222201022201222220222011012
0111010111111101111110111111111011111112211011012222121110102111201211212201122121111212120222010111110110110111202110010222011102011112012122022111202212001011
1101111101100001111011101010110111111212122002120111112212000022210121111220211022021110110211221111111110111010011212211221101121201021201121020112102012022011
0101111111111111111011110011111111110102121011211211211002210101221211101111212011102110201210212001111111011011120101011120210211211022001111201222101221111220
1110111101011111101010111111111101011010212201222111001121100221111221102021000111101201111211211211111111001111120100212202122112221012021121101212020220222020
1111111011111111111111001111110111110001202011112002110122201111121212222202112211110022200200112211110110011111210122022220111201212201212221212100022202112220
1011110010111011111111110111111011001120221121112200121002101210112201122212201111220122121002122111110111111111122120222221210111111101211211100112001220110102
aaaaaaaaaaaaaaaaaaaaaaaaaaaaaaaaaaaabaababaabaaabaaaabaaaaababbabbbaaabbbbababaa20021210211211211110101010110101112002122122221002212111210122122221111221122122
0111101011011111111111111101111101112120012220212122111221121111221202122011111b21010101111200011111111011111111020012111001112020120122112000111011111222100021
1010010110111111111011100101011101011020011012000220222222122211122222201201212b11202121002100101211111110011101211012120111112120221120022212222101001000122222
1011111101110001111111101011111101101111202122211120122220011021212110111112111b10122021201001112001000101111002112020222222022002202202020220201220202220222102
1111110111011111111110111101101110112022112112111102122002102112212120100021210a21222010121221121000111111011202221211210121021220222210220011011202011221220202
1111111111110111111111111101111101102112120102212101001000101212120020102121212b10221112201111021111111111110112222222222012201221222112012122222110120222222122
0111111001110111111101101111110111012021222011222012020201212102012022110221021b20202222221000011010111111011120102021122222222222011221012200201222202002222122
0111111111111111111110100110111110110120201111220202122021212110110010211222112a22112212121101122101111001110212112122222222202121022221101022222222222221022012
0011111111110111110111010111111110012222222112100212112111222200020212111201012b02122121202002002211111111111101022120201122112220222221212222222211021120222000
1111111111110111111111111111110111010101220020221112122020112201210021111121111b01211112221212220011110111111111212202020212202201220012202202220022220002201112
1110111110100111011111011110111111111220020021112222111122202110021201212022102a11012112121101210111011100111121200111202002022022210222202110002212222222220221
0101111111101011011101111111111111012010101012212001120122222000221100212111112a02201212111002202101011110111120122122220222221222122222220212220222120120120212
0201112212112102201122220102212021100222122221202202122021020222002121211022221b22120222122122211011101001111120221022010222221022000201002202221212022112222212
2012020221222110111121201112221221022211002011022202221102221211111101111101111a00111111111111010111111111111112222222211202202221210211202012112102120000112112
0222110211212222200010221110012212012202222120012021022010111111111111000111111a10011101011111101111111010011211110111212022022001001222202212202122102202220211
2212122022102221012121112222002221021212211221122221012212010011111111101111011a10111111111101111011010111111111211010112222210220200202220211221021022121102121
1121211220202111021220022112120020110022110022202010222101122201001111011111110a01111000011110111100111111111221122202222022002222220022112122221221010222012202
1010122212221201111211022220210112022120212100112211102222101111010111001110111a01111111011111011011111110111021020221202212220102202222202210022222202222222221
1102221201221110110122021022210212221221122202220122202121000010111011011011110a01011101111111011110111111111201122202100222222220202200202110222220021002001202
2112201122212200010121211022202010111220122222201012220210111111111101111011101a10110111101111111011111111111121111010222100201100220220022221201020120211221022
2221020121202200202022011220112201000121221101102112211122221011111111011101110a11110110110111011111111110011120221121101110011212120022022220122122222201001122
1102101110212021101210212220112102020121211202112112112210221011111100111111111a11001111110110100111101111100120111211002221002021212201220122201022120122220002
1112201112202222202011012010020111200101212112121222221111121111111110100001011a11001101111110011011011111111122102110010102212222112012200002221012012110212000
2022221210221222111221202001011112201211221110102222002110221111111111001111111a10000111110100101111111101110121020002222122011212102220122021221020011202222222
2012222111112210122201111112222002110022202111222120011202121101111101010111101a11111110111111101101111110110101112122021002211220220222202000001202012012222021
1121221212122111121222110200222201102210222211112122122111221111111110011111111a10111111011111011111111101111102022001221102112122201022221112110222200222202200
1022210212212012012111210102021222222212002020012220220221202010222201201202111a21121101101110011111111011111002221100111111222122211122222122222022212222221122
1120212100211102102222222212222221202220222121122220202202002211121221221011101a21221111001001111111101111111012021121210111222212002210220220021221122220222210
1200221102222212020202222102202200222022222020222221221202202222021220222121222b02211111111101110011101101111022111101121222022012101101222222122222202120100222
2222120022020200211202202222222222122122022210202122220222112212011010200201210a21121111101111101111011110101201112212211210210210122222001021220222202222222022
0210222221112212120222212222212222220002222222220112011112122220102120012220222b21200110111111011111aaaaaaaaabbbbbabbbbbbbbabbbbbbabbbbbbbbba2102001220222202222
2200222222221212200212212020211222101212222022221201122210222202012112211101111b21001011110111111010a100111012222221222102221222020222222200b2220021220200022222
2221002202222222002022022002122222022222222222202222202202210012121121121112210b11121111111111111111a111110111101121022222020220222122222222a1110010212222000222
2222012202220222222222202010212112221222020020101220222222022222210200222100020b02101101100011111110a101110110022220222222022122221222222022b2122002120222222011
2220222221122212012101222222022012220022222222021212221212222020110212022210211a20101111111111011101a001111112202201122202220212200022122212b2202021222222200220
1220210002222222022202222222221021222222022222221112122022220212220011222000021b10221111010111111110a111111112221002222020222222212222202220b2221222222222002121
2002002202022112222022022100021022222202222200222220221222202122111021102222001b01211101010011111101a111110111122120202220210222022222002222b1020220022220022022
2222121222022012120222222010220001202020220022202021222221000210200201212122010a12021011111111110111a111111012220101120222101121202222210102b2112200222202222021
1220022122101222222221120122002222220222212020222022011221021221211021110112112a10011110111111101110a101111101222002202222222110222022002221b2222002202220222222
2222121122222211111111220222122222201222222001122222022221212111102101101021122a10020111111011111111a101111111112122222220221222212222221220b2220122020222222022
0222221222201102001222222220220222212222212200111210002102222211011112201122111b12011111111111111111a111111102211202221222022222222202112000b0210220022200222222
2022222222202210211202222221220222121222012212210122120022222201122211100110121a11211011111111111110a111111112001212222212220120222210221000b2102122212222202212
1222202120221222222202112010122222002222022221222021220221202220001210211122212b22121111101111001111a010101112122122000221001220220202022222b2122220221021122221
2120002222120022102102222222020222112120222002222021222222122202010101210011211b21210111111111111111a011111012111202220002121012221122022220b2122202222202011202
2022000122222201022222020020122222202020022222122002222012122022101101012211111a12211111011111110101a111110111202202200221212210220122022021b0202010202222020222
2122102221221200020222202220222020020022220122122201112220220201222202220121110a21121110111110010111a111111110202212222220222021122222221210b2222202002220222222
2210222101222112022222222020202102222002002222021111222220201120011101222222122b11110110111101111101a111101112012112210222120202021222000122b2222222220220020022
2011202122022122210210202222210202222222222200222222222122202201020022102202010b20021110110111101111a110111112222002022212201220122222202222a2020221012120022222
0221012222212010202211022222122200022120222221222022112210212220212222220111122b21011111011100111100a111110102201121222220220020212222202222b1220022220020002222
1220012212010002220222222222222202220200222221222210221222212011112012011212222a02121111111111011110a111001112220202202222221000221222222222a1201012021022212222
0202221122222102012122102222222022221122020222012021200211101210100221022122112a02211111001111111111a111101011222222120012022022222202210220a2002222022102200200
2122202222222222202222212220220222212202211200212220202201200202010120020222201a21211111111111111110a111111112122012122202002202022220222222b2021001222220202202
0221220201222210002202202222202022102222222201201200121201222222202122200111101b10221101010010110111a011111112210122200122122012222202222120b1220222021010222222
2222120202202001022222222221221212212222002212100222210222110201011201222222221b20001111111101111101a101111110000022220001201122222020212122b2222220220201120222
2201002202202022222212222222022020112022222222011222222222120221211211201222112b01111110101010111101a111101112220121222222122222222221221012b1222022202212222202
2120210022022220202222020222202011221220222020221221222212212021110220111100212a11211111111101011111a111100012222221121122200200220221220202b2220120222120022222
2012221022222222002221222021222220200202002222222202221212200221112121012112220a20120001111111111111a111111102210222021202102002212222222202b2220222012222222201
2021220222200200122202120100222021022220120220222222112222220122212202200211201b21221101011111111111a101111111221222222222212202220222002222a2222222222101221222
1022222221000100202202120212220222201222022222020102221022022221010121001112202b22201001101011011101a111000012222212220221200202221202220102b2002220022022220222
0222202222222121012021222222212222222202222220122221222220221100102111102012212b12010111111101011100a111111111101202222021220222202202222222b2100022221022222222
2221220102222122202002222222221222122222210202020122222020012211221211122201101b12011111100010101111a111111102122222202122022222222002020222b2222220220202222222
0202221211222222101222002220220222222210222202222222220212222221110010100110210a12121111111111111111a111111112212222122001002102120200201012a0021222222022211222
0222120202202202022101102210002222222222222202122220000222200212111211110100200b10111101010111101011a110110002210122212211211122212222002202b2221200222222220122
2202222022122022222112222122222000222012222222122022202020202212222222212111202b10221111110111111111a111101111020222222020010100222212222022b2222212122212202120
2202022002201000222210022222220210222002201022201020122220222221102020221202011b12120100111111111101a110111112202222022221100202202122000222b0222202012211022212
1012022222202222221222202222220222220202222222210220220212012212111212112021020b22221111111111101100a111011111122021001112122222222222220202b2222022201212210022
1220200220202222122110222122222220212202202010011211022211211220011211211201011b12121110001111111011a111011110200112111100121211022220212122b0212221122222002212
2021201211212201111011222222212220222110201202100221222221022011010210100210012a01111101111110101110a111111111212221212120210122020122112022b2012122020122022022
2122022202112222021022222222022212201212022222221222200220022212010220200102012b21221011111110111111a101111012022112021112122222220022222200b2220211211011022122
2122002021202221220022222221221120222000122222122212222220021111201212201111101b00111001111111011111a011111112212022012211222121222022221221b0202202210021022220
0021222111122022222202222022222222120122221210022222002201222211211201201102201a00211111111111101101a010111101100221111010002202220221002222bbbbbabbbbbbbbbbaabb
2021001202220221212012021202120222012202122200122222222222112212212012221212012a02201011011110111111a00011111101212211211212211212222102222122212002122012221202
