120,101
14,43
95,107
50,57
60,84
47,64
142,109
150,50
138,95
95,33
01111111111111a1111111111110101111111111110111111101010111111011001111111011111111111110111011111111a0011110010100111011111101110110011110000111a111111111101111
10111111110011a1111101111111101111111111100111111101111011010101101011110100111110011101111111111111a1110011111011111101101100111111110101111110a101111111111110
10111111101111a0111111111101111011111111110111011111111111111101120202011200022012122101011112210010a2210112202202202011210201110101111001111111a101111010111000
11011101000011a0011111111111111111111011101011111111110011101110211112101111211122222012011212111111a2002002211112011222121221101111111111111100a011101110111111
11111111111111a1111011111111111111011111110111111111101110111010212120022222221221111111022111002111b2222021211111121022001220011110011011110111a111000001111111
11011111111010a1111111110101111110011111110001111110101111100111122112011012120211122112222021222121b2001212102121211112122211110110111111010111a111111101111011
10111111110111a1111011111110100101100110011111111100111111111110111111021020111112011220222022202221b2210221110112100202112121110111111001101111a111111110101111
01111111011111a0111111111011111011111101110111000011110100111111011222221121202111022010222012210002a0120121101122100001012101101111111100111111a111111110011110
11111111111101a0011111110011111111010101111101111011111111111001011012212010221120012002121221112121a2001012121220221211112201111111111111011111a110111011111111
11110011010111a1111111111111110111111111111101100111111111111111100120012102112001221102221121101111b0121220201012010102211110110111110111001111a011111111111100
11011110111111a1011110011111110001111110111111110110001111101111120222112210021112110201122122202200b2122122221111222210002122111111110011101111a111101011111011
11110101010110a0111100011111111011011101101111111101111110101011210201212212001220112122202010000210b1222021102122002010111100001101110101111111a111011111010011
11011111111101a1001100111101111010011110110111110101101111111111112222000222122002120011002221112101b0220121101020222221022202011111111111111111a110111100111101
11111100101111a1111010111111111011101110011111110101011000111111102120011101111102211222211220222102a2201002112201020222110211111101011111111011a111111011101000
10111111011111a1111001101111111111111111011011110111101010110111121101101111112212102022102120112122b2112011121222112212212221111110111001110111a111111010010011
11111110111101a1010111011101101101011111111110110101111010011011122211121112212101211112121120102222b2022222112222110212121202111010000101111111a111111111111101
11110101011011a1110111111111111111110010111010101111001101111111220101110100122212221121201220011122a1011111210021112112212122011111111111101110a111111111111101
11111111110010a1111100101110110111111011111010011001111111111101020122121120202222220222201200212211b2111122101211210201202112111101111100111111a101110011111100
01110111111111a0111111101111001111110111111111111111111111101101121110221202112022210211111121201222a0202212100112022022101101011011111010110111a111000111011110
11111110101111a1111110011100110011011111011111111111011111011010200211020201210012222111201002101101b2202122211211102122221212100022121011021111a002220212122022
11111111111011a1110111110111010011110111111101111111101100011111112212222010221112200112112221212202a2022221012212001122022220102102212112101120b000012212020120
11111111111110a1111110110111011111011111110111011111001111111000002110211112220222212220111012202121a0220020012112001100102212102220112221220211a122010112111022
11111111001111a1111111011101111110110111110111111111111110111110221120212211121222021221112212211012b0102220202001222220022222200112010122122102b111122201021001
11010101100111a1010111110111110011111111111000111011011110111011022211021202221021201201212121221222a1101222122221012110002202122012011211011110a222211220121112
10011011111101a0011111111111000001111111101001111111111111101110222210200101122012112121122200021111a0211212110112111222202120222012112121011102b022011120101102
11101111011011a1111011101111111111111101010111110110011101011111212012222201022212012112221222221212b1011211112022010111022120112211211011210211b211112221200202
11101111111110a1111010101120012012121202111212211121212112221200002002202221120222020212122210021212a1122022001221012121222212102222221022110112b122012101121201
11101111011110a1101212110010210212201111110002212101220212010222212022222020220121021111111220120112b2211121121111112122202201202112221022222210a121222100002110
11100111111100a0101201200221101211222221202110001011121110122201120202202112220210211211211212122021b0002011111000200021022202102212221112002111a221212121022021
01111010111111a1100221122222121002022000210111022012221222112000220122221122111120001112001222121212a2111201100122220122220222212101121221212100a112220212122102
10111111001101a0111212022122022202220210222012220201202111102020220022222222212221121102222212222022a2211010020202222212202202212211101001222020b000212111222221
11011111011111a1110012002211221101211012122220121211221112211021210202222122212222121210111212202211b2221011111212221212122212202101021210221212a021211212121120
01101101101001a1111210120120110222010012021100202101112020222011022202020121222222120201112001220022b1010111011221120012202222201110000201102212a202012211211022
11111110011011a1112202202022112222011222201212202021222122222112222202220020121221111011211211021102a2201112020020221100212112001211102222021220b202122221110121
01101111011111a1211002122012220220202221212122021011101212222102211220002220221001111201221111212111b0221112220122102010222202122112122112221211b221011211001101
01100111001111a0110122102222220222222112212000111201222221222202201202220122201222212112201211211010a2122111001100020022222221121212122211200202a122221020210221
11111111111111a1211222222102222202221201022222220212222220221012122022122202220022121211121221211220a2121110112100212222011222122122212101011111a221102102212010
11001110111101a1020212022211220222002212012211222101212020022222222222222222220212220101020201202220b2120200211012210011001212212121222012212111b221121221111211
11111011111101a1212220201110222222102110110012222212022222222200122020222122220220222101012012212222b1221221221121112112222222121110002222220122b122212221102122
10111111111111a0021102222122122101212222122222221222222202122202221221122222112210111120221021101001a1222201111021222011220202212022122222211111b110101121122200
10111111111101a1102222120122022102212221212220201200020111202022120222212222222201111220100010201222a1112122202122201222220121212201112201120022a221221021211111
10011111111111a1112100221120220212220221222122222120020122202022212202021022221222122110111111221110a2111012100200222202122220122101100212220221b220222221212211
10111010001111a0222222022200210202222201222200200220012222120022221012202001222220202021111102100122b2121101002121211122102212200122222111222021a111220021012222
01111111101011a1221222212210220201012122222002212112222220110222202220222222022212220120121211212110b2210010120201211222222120002010201010002122a011211100022211
11011110111111a1201220012122022011202021001000012220222020221222222200220202222221121201211210211212a1122211222210210112002220111012102112210011b111021111021111
01110011111011a1121222220002101022222122102220120120112122222220122220202221222211202222022011121221b2210212210111222202221210122122021201120112b012102100112121
11100101110010a0120202220220221220000212122221222220222220212202222222222022222222012220211212220112b1201222121211122112222002001210221111101122a112200101122012
11111111110101a0002211221222201220122210220021210202022120202212022202222122200222211220002120210211a1221210121212200120021022011222011101110201b202212121201122
11111011011110a0102202220220220220202211000021210110021222022000202222222002200120111112201201021120b1111000202121112222212222222212211122211221b012201120210201
11110110101111a1201120122222100222021210222200000220202022200011200222220221021211111110101222211222b2210210111012211112202222011022022021220112a212102112112022
11111110110110a1221022100021021220021101222222222212212200022122210102222002222002221221220201020121b2111210221122102021202210222201002210211012a112111101011012
11011111111111a1211222222012021220010222102222112211202211002121220202201220222211222201220202111120b2122101220112022202221212210021122021020120b112122221220200
11111111111111a0110212212012222022212222020202112222022202122220021222202101202120211212121210111222b1022222101122211102220222201221121121112002b010111020101101
11111110110111a1112022022202120022202220120212221222222221222220220222222222222222012020202102121222b1012200012211112222221222211222002110221022a121222100112022
11011011111110a1111201222100220202222220222222021220200002222221022222222222220122202112221122122112a0211120011222220222210021101222012012222122b110221111122222
11111010011111a0001220121221222211122222012200012220220220022220002222221020202201121222112220222121a0210001002022201120222222110022212112212210b012011221020121
10110100111101a1122212202222220212212222102020220221222222202022221220122222012221022122220100200122a1221111220122121112011202000102122111110211b122022010120012
11111101011011a1220012222122120121210222021220220020002222220212002202222222222220122222022220110110b1111220221110012022222112112101022002102022b212121212122210
11100111111111a1021121002221210222222220221202221222102222122222220222202122222222022122120211101221b1021201112220102010222002121211001111110220a220212211200010
10111001101111a12022babbbbbbaabbbbbbbbbbbbbbbbbabbbabbbbbbbbbabbbbbbbbbbbbbbbbabbbbbbbbbbbbaaaabbaaba2201211221101100211212212120212101210020121b211200221210212
11101110111111a02221b021222212211222220220022222020222202221122022222222202222020020202221211222122120100210021222202221221012121222222111212101b100112011211122
11111110101001a10201a222120222122222120222222222222202222202022222212212202122222022100222211220112102112110021220200111222110221011221011112102a100111111101212
11101111100111a11222b222202022222222002222222012221220222221221222222220222222200202122112222111221001222111111111221220022122121112221112112110a010012210122202
11111111111101a10212a110222020222022221102222220220002222222222020202222020022112222221200212111202212221210222212222122202222221221211211222022a201120212021222
10001001111111a11112b220221122011222020222202022220200222220222020222120020222221112111120211011011011111110212001221022222022111220121201001202a222202222212020
11101001111111a11000a111201210222220022022120212220022200012220222220222202221222012221221111101101111101110011211211102122222202022021202221212a002222022222102
00111100111101a10220b222221202220210202222222212222022021220202022202220022222222001110011210111111011110112112022012110222211221202201212101220b012122222012121
11111101101010a01021a202010222222221222220210220222222202001222210220022220220112111100211011111000101111111110222102220221120221022122121122020b222120220211220
11110111100011a11012b122120100222220221222211222222222222222020022022222220120222220111120211111111110101111201212012102212200222220120011102212b022110221102022
11011101110111a12012b202122202122221221222001222222222222220211122222122022000202112221020110111010111111112221111102222220202222212221222010220a210012022220200
11111100010101a12112a221222212022222200222022220220202220212222200212222022020102102110020210101111111111110002021022101122020222221112101112220b201122222212220
11011111111011a12200b222222120022222210221222001122112222202222220202222122221222211122121111110111111010110012202202221221222220122221212020212b022220222002222
11110111011101a00021b010022212221222211120122222202222222122022222022222222222021021012120011101111111011002121102022012221220222222122202022022a221122200002212
11111111111111a12102a202112002212222220200221222222001200221220022220012210220222112112112111111111111111112102202211112202220222222202220202222b212222122222021
11001111111111a12022b012212210101222222210112222222020220222212220022022110000201212100022101111111101011102101001220112222022210211120121222022a222022221202222
01101101110011a12220a121212222221222202022222122222222222221210021200222222222222222111122011111111011111111102121121210002222221202002222220122b211002202002211
11110111100111a11201b212102022022220222200012022222220202022222000022200200221020202002122202012102222000212012022022222222222202122202102212002a022221010211222
11111111111111a12122b222222122020202220010021222020220220222212122020222222022222122210210220121110212220211202202222222022120222222022210112220a220201221221222
11011111111011a11212b222212222220222222200221221222022012222000122020222020220222211210022211002022121011122222220222200221222022220222222122221b222202200220222
01110101111010a11201b221120212022002202122222200102212202211022220222211212201212222022212212222122220010122201222022222022221222220222221202222b022222002221220
11111010110101a12212b220210122222212200222002222201202221010012222222222222002000120210202211121211202111212202012121022202222022120221212222202b020022022222122
01111111011111a10022b222112210022101200122211222202022221222220022222222122222022112120022221011101111212002200222222002222222212022220122101020b120222001222002
10111110110100a11012a222020002212222222021222202212202222202222220022212122222202202021022101202112021122220202222122222222222012020222202220201b002202211222022
11011111111111a12212b020202212222222222012222121210222020222222001022020022022202212221002202121011202211112222222220212122222222221222222202211b221212201202022
11000101110111a01112b022012012022212222220022010200222222221222222222222022020122122102220210112122201002222121222222222100222200001112121200210a212210212202220
00110111101111a12212b210202221222222200222222222201002022022020220200222222222120001122222010220012122220000102020020221212201002122122121221212b212122221002021
01000111101101a10110a112221102220001020222022222222222221222222022202222020022022222222011022121222212221102022202200002220222122221222220222222b222220002222221
01110110011111a12201b112020202002202102222001222022202222122012222202222220020222222221022220112111002202122221222222122210222222122211222121002b210122010002102
11010010110111a10122b122212022222102211222212220222021220212221022222100222222022022200202121121122212122200111202222022022022220021221221210222b222121221220111
11011011111111a00221a200200211220121222212120121222210022211022102112122222222222202122212121002212022111102202222120120222201112112002221201120b222222122011001
10111110111111a11100a202011122022222221000102012202122002121122221122222122022012212221210212212002120221211222210212121212202102212212222222122b210221022121120
00011011110101a11111a022112102210122212002022000012122121010112202212200220022022201002222120020220210221222222220021222222022221022121211021212b211212201221020
01111110011011a11122b012112212221212102202222210102221211012002222202222222220020212120220221221111220110222221222222022222022220202202201220220b020001221222221
11010111111001a12111b212001222221022020221222211000112120222222022220002022222221212120222212211222220211112222201220222222221021012022222211202b201222212221201
11110101111010a10222b121212212211201210222002222021020222221222222021222022202221201020122221112222122010221221000202222100222212221212012220222b012111222220221
01111111111001a11111a001001112111121111112200200110212200211112112222222222220222011222212121201011121122022220220222220020222222012222122222002b222021222122021
11100111111110a11111a110111112112212001111112222210110002111211212122212210202222112220202221200201011201212221222221220222012220222212222212220b122022021212102
11111101101111a01011a111100112111120200012011102201221102120012100212102021122121022122012220022122212111222022022002222212002022020222210222001b122022222212222
11111110110111a11110a111111112110221212220112211112101212012122220222222222221222212222110010222121021122122220220022120220220022022222001022002a220110022001210
11111011011111a11111aaaaaaaaabbaababbabababbababbbabaabbabababaabbabbbbabbbbbbbbaaababbbabbaabbbbabbaabbaaaababbabbbbbbbb02202211020222212202002b222022222122221
11010010111110a11110111011111bbbbbbabaaabbbabbbaabababbabbaabababbabababbbabbabbbbbbabbbbbbbaabaabbbaaaabbbabb0112122020b22212220212220220212102b202202120010110
11111101111011a11111111111010a0201112011110012122121122010020222120122222222122222212222221221020102010120202b0222022221b22222220222222112222200b100112222122220
11110111111111a10011111111011a2120012221112221011122002122211110020222022212222220222202012010122221221022011b2212220202b22202112012202022122202a222222202002222
00011101011111a01111111101101b2210111200222112012111121020120121222122022002212222220020221221122021120200222a2200021221b22202212121220222222120b221222222022202
11101111110111a11111111111110a1112100122211021012012200212212102220222221120210220122000021021100110122021201a2212121220b20022111221200112222212a222021012200202
10011110111101a11111001110000a2201212112010211112222221012222112222202221022121102110222021221121202211110202b1212000202b22220012221202022211212b220222222222220
11101111111011a01101011111111a2020002202221022112122210112111021200222011212222012221102221121200121102212112b0200022222b20222222212120210222122a021121222222011
01011011111110a11111111011110a2022000212221210111111112100112002221220211212022122222022201022212212211011102a0122222022b22222222212220121212022b012002200012120
11111111011111a11011001011011b1102000211111020022210101020022211222211122222012222211122222212012111022102122b1220222222b20022212220222201211212b220222021220200
11111111111010a10110111111010a1100012120220121120220221011011211211202022001202021222222220101221021221120111b0222010222b20222221102202021022021b200222222212220
11101110111011a10110110111111a0222112221120122210222121111220100202122220211020221222222102212201101012211212b1020222201b12222022221221212222221b221112200201222
11111101010101a10111111111100b2002212120221211222100222222022011212021020202110202022222222112201222222122122a2022022222b22021221221220021022221a222220212101222
11111110110110a11110110010100b1010221212022210200220211211001111122221222202200221101222222201112011222120121b1022011210b21222212220020212102120b222222202012210
00111011111111a11111110011001a2201111200021112100200120222111120222222222212122002022212222020112222101102102b0222222122b12220022121022022012020b022021222210222
11110101011011a10111111111111a2102201012112101111121222120112112102202222220022222220022221212112111221112022b2222001222b20211122212222221120222b002002202220222
11110011111111a01111001110110a1110010111111111110011110010001111112022001122112022002102201022211011210012010b2212222220b22122101002221222212020b010121202201201
11111110111010a11101011111011a1001100011111011111101111001111111221222121220110201220111120210211010101111122a0002022222b02222222022202122122222b120002220121122
10111001111111a11110110011100a1111111111110111011111111111011101011212222212100111121212000220221200221200220b2222202220b01120101111202010022222b021102022210102
11111111011101a11111111111111a1111011100110111100010111100111111222102211120212002122210122122012002221122222b1010222222b02222222022222220222012b212221121220212
11110111111111a11111111110011a1111011111101000111110010100111110222222201011110011011220211120010010211112211b0212222022b12202211212222201122122b202222022120202
