138,17
11,76
84,59
40,80
144,11
42,80
53,73
113,77
10,42
94,8
1110111111111111101110111111110001111110a01011110101011110111100202211211021121102021211001022201120220111210012222222220122022212221210110220210110012121120102
0110010111111111101111011111110111111110a11100100110101101010102111011121200220222101121110211222122222112022122112022222222211121212121022120202122221021112002
1111111111011101110010111101111111110111a01110110011101011111101122202211202012212101111221121212011020121020101112212102122221021112110222222202022111220121222
1011111111110111111111101011101110110111a10111000101111111101101211222111221120200111220120022011122021200001211000222212211112112111122201210211101011101220001
1001111111011101111110111101111111111111a11101101110111111000011122122122012120101020021221121222111110112222122121221211222212011012212022121212212221102020112
0111111111110000101011111111111101111101a11110011111101110111111222021211221212102011222102122101011101211200101112222012212210212121220110212121121011011011222
1011110110011111101111111011111110111001a11101100110111110111112101121122011212222012112200210112222011110021200122222202221122121120200020111211120212122212212
1111101010100111111111110111111110101001a11111101111001100101111100120111220222112210222102111111221120021210012122021222222221111222212121112021001012221210101
1110101111111111111101111111111110100011a11011111111110101011111121221122010121011112111122022102020212011202101102222222211221022002122121120101120101211002121
1110111111111100111011010001111111101011a01011111111111111011112022210212020122101000121121022221122212011022111221100122200202122011111200211122201211111221112
0111111001111110110100101111111111111010a11011111111111111110112122121122221110211110221210210002012121211202122012221222022112212112100102212002121212101212211
2021202211121101111101111122221121222120b10101110110111110101011212202022102112222222202212122221222210221211022100201222102022200112122012120011202021210212112
1001222212202220220212010102211110121101b11011111110111111111011110111101221220120222120202012012212221020112121222011122102022102011222112021211001121211010110
2010211020121220222110212022122212210021a11101011111111011111111211121200022121212222010021110021211101102001012220222011220221112201110121121022022102110212122
2122212101212122102211110101102122210222a11010111000110011111001021200222111222211122102012222110012121210122120221222021222211012012121121211210100002112101211
2112111121111221122210000202221122022202b01111110011101011110110211112121020111202120200121211220211200201210212221222221200221011020021121012112022201212221122
0220101101000111120102012222122120211201b01111111111101111010001111221211022020212211001122201212102211212200022122122222122002211121002200012121202212201220212
2201212111112121222101102211120112111201a01111111001010100110110011122000201220121111100221002012202212110202212200112200212021112121221221211212221001122121210
1112020111121110011010012021222121121211aaaaaaaaaaaaaaaaaaaaaaabbabababaabbaabaabbbbaaabbbaaaaabbbbaaababbaabbbbabbabbbbbbbbbabbbbabbabbaaaaaabaaabbbbaabaaaaaaa
1101011212201122020111120022212221211221211111111111111001111112100020111011212220121101022102212112120121202202002222222122101122102201010102110121121202221112
1212021022102112100211121111201101012222211100111111111111011111222220220210121220222002201111111011221112002212110222112212220002022000121211211220221222211002
2112221201122120200121111110212202111121110110111110111011110112120222121220002221022111010222201022121001111221222010220001222111201101221121101212202010222220
1121212210121212011022120112202102212212011111111001101011111010012121211020112012110211222212201001102221102110222110222222212210210212221121120122102210012212
bbabbbaaabbbbabbbababbbbaabaaaabbbbaaaaabaaaaaaaaaaaaaaaaaaaaaaabbabaaaababbaabbbbbabbbbababababbabbabbbbbbbabbabbabbbbbaabbbabbabbaabbabbabbbabaaaabababbaaabab
2111202112122120100120121121121221211121111111111111111110111011220211020121221121010212101111212010002112112122102221202222122011211121202011222211211020101102
2112002022222112221222221221011120211111210111110111111001010100112122012221111212101012212112222220122020102200012222210221111222212122201111210121101202010122
2211222200211212102101221001001212212110111001111110011001111111212002220222212112111211000111121211212111121210111201021212212111121220122211012022012222120211
0210211222102222122112212111122122120021111111101001011001111110122021221002220212222202120201212111120012112221112222012002012222020102221121112021112212210220
1102221202102020222221122122122021122212211111111111112110002222220122002202220210220220022122021202022201001222012020021211221210222202110020211210111210211102
bbbbabbabaabbaabbbab12012120111220022121211110101111102201221110022222212122002020202202222202222200222222121020022121102222211202221111200211102121202222210102
1222221012102102111b12201222011221121122010011111111110102112101212202022222222021222201022220202102022222222210221222222122220012122112102222121122210122012221
2112020221112221111a21111000122022201210211111101111102212021012202222221122212122221222122211221221122022212011222022212100021201112122122011120202111021220112
0222101101112111112a12121212011221122121111111111011001112220002222022222222222022200122221212020201112022220212102121222221211021221021111021112002012211120102
2012120221121200201a21122221112122211212001011111111120211021202222020222202220002222201211200220002120220222202222022012212011101210122101002111010011222212102
1121012222210022122a21101122021111202202010101111111120122022202020222221222222202202012222020222221202222222002022121121022210011111221112112210112110010102211
1212111121121201221b01222122102021120101211011000101120112220012022222122010210122002202222110222222122222212220122220222020200102122010012022211222101212121012
1210112222022020120a21002220212021200222211111101101122121101212012211220122020201222022022002102002221202022222221222022201221112112001011110212222122112102222
2220122101121222000b11022112021000122221200011111111000122211120021221222222222112122022221012222222220222000100222102222222202202112001201212120002111210022210
2111022111222201201a20102111001120221201111111111101112022022211111122220222200212212212222212110211222221211221022202220122012210212211011202102112122210101221
2121221120212211012b00021100210120211122011111110010101112211221212220002021211211111200202122022221001022021212012211221111112112220102211012221222221212001010
2010101022122121220b22202112221002010202011110111101001201221221110212020102211122120211220111002202221211110011002012212001222211111abaaaaaabbbbbbbabbabbaaaaaa
2000112112100221221a11021210122201001211201101111100111221121212111112112121022122211121201110221111122122201201022221210221122221121a22121111112202211002201112
1121210112212012220b20101200022101022222211022022212021022122102122222200112221222222220010021212211210111121212110111111111110101101a01110010101111110100111101
1212221122222121220b11211202221222122102212012101121212222100210222222122102122022211220121210102122221020202212122111101111011111100a11111111101110101111110011
1102112001121210201b22122220101202012010010002211112002212222221222212200022120101222111211121212212012201102111222011111111111110001a11111111110011101111111101
1222022121221100121a02020121101221022222210201120112021202100121022202210221202222221201012022202122210022111221221011001111111110001a00011011001111110000111111
2122112102221120221a22002202002122200012222112111122122202201012222002202220212222202211212102110222102002212212211102002111000110122a20121101111101111101111111
0122220111111121222b21220020222222210222210212111101221222010122101222221021220202222221221011222220002212212212200221012221022200011a02211212001111111110110110
2122011222101102111b01122102210111122120201202202011120222022211022202222201121222212022221222221212222222210100221212021121202121102b21122211111101011010111111
1202212222222202202b22202122220222202220222221222022222022202222202222220221222212122121222212222210220102210022011212012211211222101a20112211201101011101111011
2210110022222220222b20222022222222220022220200220222012222222222022022220222211122021220002221120022222202212102200211011110101222112a22111122201111011101010111
1222210210022220201b22222222222222222222222102100112012202002222222020002020221112202102200222222222221020222002001211202120212121212a11212122111111111011111111
0112022012222222202b20222222222200122220022001202121220220222202222221221220212022212222021202210222222222221202010120120122222122110a10210211221111111011111011
0211122102020202210b22222122202222222222220212122120122202022222220220202020002002202102021021220102221122102221010112201221120221101a21220212011011101110011110
1011111112122002022b12222122222222222222200220021122202222210200022222220212102122222222212200000022122222021220212111111220002201201b00011212121101010111111111
1121212022212022222b22122022222202222020222002222222202022211222220220220201222210222220202022200222222222221122022222210211121111210b12021111110011100011111110
2112110200222202222a22220202222220220222022221221222221122222020202222012221222202002202200200222210222022002222222111021211202112022b11200201101111001011011101
1222211122022222222b20202222022222022202200222220220222122222220222222000022222220221012222122120212220122022111201111221220102212101b02001120101111111101111001
1000221220220220012b02222222220222222222020022222221221222222222202202202212010222022222112221222201201211011111222111021202221101112a02211221101111111101111111
0202112012220122221a22102022220212220222222222022122222222222012222222222102011220202122120222020222121121002212221010012012212210102b21221210000111111101011011
1222211102200222220b00202002202202222222222202222122222222022222102222222210212222022221222122221220222012212212220012102221211200112b11122222121010011110011111
2222121202200212022b01222200222222022222220212202112222222222202222222122211202221221222222212120220002022012122112222201021221201220b01201221221001011101011111
1012111000222122222b02022222222000022202222202222222202020222222222022222021221122221021222112222022102222222102112020122110111110012a11012221011111111111110111
0102222000022222222b22222220212222222022222222222202222221002221222022200022200221212222212222222002220222001222212102201221022220201a12021002111111111111110111
1001100211202022222b22202222222222020222220221222212020001202220222222222221221121022001222111020222121221202122021200011121111011222b02111211100111111111110111
1100110222221222222b22222202202202020222212220222122202022220122222202222220222221201120222222202221222202212012201001122112111112101a11012211121111011111111111
2211211022220220222b20222222220022212022212222222222002222222202222002212122020020022221222222122021022122002002222020111202011120120a10201211111010101111111111
1002220212222012222b11222222200200222222222222222222222021002212220022021112012121022222221101122212212122220221012120101012111122221b22120220111111111111111011
0011102221202222202b00202212222220222222212202122122222022022201220202222202002201021122010122200212021222110122212002102120211112012a10011210101110011101101100
2212210112220200002b21202021222222220222222222222020222222220202120202222222222222021121222200220211112122012012012111211112202122111b02022020211111110111011110
1201101222022222200b22222220220122022002221220202220210022222122201222221221111122101022202221202022222211220222102012121111102221222b11101220111111111011011111
1211212002022220002a21021222002202002222012202222102122222022222021120222222021222222221002222212222202002202112220200110020200220101a02100112221101111011010011
0221222220202210202b12022222222222220022222200002220002022200222022220222220021020220221200120200122112010121221121212011021201112221a02210020221111111111111111
1110101112221121022b21222222222020202202202121200222022222022020002020202220220222220212121022222100002222021122222121122201111120211b21112021211110111111011111
1011001111222221102b22202022221022212002222220222021012222202202102021222202212222022200222012200022100011020202220202221222011211120b12200210220111111111001011
1111111110212222102b02022200022222002222122220221200222202022222220222222220120202120212202022021202222222200222212121121011220122100a11121211211111111111111111
0111001112220122222b12222220220222020222021021222022122222222020222222222221011202021222221222220221222222002120222120221212111122202b11121112021111111001011101
1111011001022002122b21222212122222220020002011212121122222222222202122202222210222222202022202122022002002010122212112221211112012102b20222220211010101110111111
1111111112110222020b02212222222022221120122202221221220202222020222220020220222212222202010200212121110020020222220221121001121101221b01110102101001011010111111
1110111112222222222b21222011220122222212022121221020220202221222200200222212222112222212020022212201222102012222222122211212121210112a10112121111111101011111100
1111011112110022222b12022022022220022122222220022122000222222202202222022022222022220102222212012202222220222022020001122122102112200a01012121211111111101001011
0111111101121222210b02220222022221220221222220222222202020222202222222220210222120220222120222021100212001122222211212222211110200010a02111222111111011011101111
1111101101112020202b21200012200222222222122022220202022212202222220222002222222000220222022022010220120021122201112102011022012120100a12020221211111011111111101
1111111110022220021b22222022222202200222211022222200220021200222222222221220202022021222221020122112122222222012012020221121002022121a01211102001111110010111101
1111111102122020201a20222212222220211222002200002222222212222222022221102222202212222021001021010010022102211102022122022101121100012a20212110121011111111111100
1101001112202020202a22222222222122212200202222020021222022020122022220222202212021212022212020212200221221122222222121121122121102002b20220210021111111111110011
0110111111222120202b22221122222002212200022022220201210020020222202222220021022020222022201202022211220122222102102201101212212012021a00121102211101100111011101
1101111110002021022a12222222222222202222210222222202222220222222220220212202222222212222101222212122022121220222012102001110121121122a02210202201111111001011111
1101110100112212202a22202222122121202022222222222202222211222222222022022121122222221222222222002022002222122012222220112220121221220a22002202220111111111111101
1011010002120221201b20022202022022212222222220201021202222222021222212222220221222021212020222101122212202220202201011211122201111201b22021012101010011111111110
0111111112211222222b12222200022202222221222202222122210222002220202222001120112022020022210120121021221101021111121210210121221022221a02012121121110111111010111
1011011111022122001b20202221202222222202200220012211102200222222221220022122122202211101210111100221212212211111120010101222222212212a12001111110010111110101010
0001101112122122220b02220222020102222221001222022022222221200222220202002211220110121221111102221102221002120012220012200111101222020b10021001121111111101111001
1101111102220221200b22222222212211210202222102212202222202220022222222022212200222222121121121201020200201222122110221100121121102222a10101122221111111111111001
1011111001122212022a22022222202002202222021022222222120122220010020220022112222112112122122211101210121211202110120120012212212001221b22222221020111111011110111
1111111112112210022b22022222222222222222220211202200012202222202222222221002111001220101211110222202212021012112112112001210221112100a20111020121011011111011111
0111110102111100002b20222222210222202221222022222220220121222222122002010121201222102220222211001222112222222121122000212210121121112b02112021121111111111010110
1111111111121221011b02222210022022022211022222210222022022000022002020122121222012220112122011112212110110100221120212222102212221012a10111202011111110101111111
1000011110201202020b20112222222222022212220122222022020210222012222222002021101212222111212102221020221110202202222022102001120221120b01020220021111001111111111
1011111100222212121b22221222122222110100222220220220122002202202212201020100112111200121121221010010211221101112112111202020112212222a22111201110111111111111110
1011010112211122201b02022000021120202102122201001222222222222200002222022221111110101201210212102011221222101112111001111221102202210a22221021211001111110010111
1110111011110021212b20222220122222202202021201022212222222222220221222220121201210222212222101202000121102110222222210212021112200112b00122000100011111101010011
1111101111122102222b20220220102222212202122202022222022222200220022201220020210102222101202002212020121211102122110221111100202201111b20011101211011101101101101
1111011011202212212a12222220212221202022012222222222210202000202220220121220211211200100211022120022100121002211021111100101111122121b01121000211111110110100111
1111110112222200202b22222222212212121022121220120012021222202122222212201111010111112122111101112021222121121120222110212222112121221b22221020221111111100111011
1111111100102222122a10202222220020222201222202212220102221020201010211211011111101112221210202010221112202122101120010111120110112022b12020100110101101111101110
1111111011022020002b12212222220120212202022022220222020220012222220202011110111111201021211201012221120021002222210202111110121221020a20121111111110111111111111
1111111110111222212b22220022202122110200221212220210010122011022222212201101111011212122211112010111212112011212212202011222022110110b12021122221001110111111111
1111101011222112211b10202121000022222211212112022020202220211220202021210011111111011111111101111001101000111110101011111111111011111a00111101101110011111111111
aaaaaaaaababababbbbb01200022222021122212220211212221222102222100221201211111001111100111111111111011101111111001001001111111011111111a00111001101111111101101101
1111110112202112021022221222222122020202012222222222022202122001201201221101111111011111100011101101111011111101010111101110111111101a11011111111111011101101011
1011111101101111111101111011111110111101111101101011111111101110110110111111011110011111111110110111011111111110111101111111111111111a11111111101111111110000011
1111100111101001111010111101111010110110111111111001001011011111111111111111111111011101111110101010110111110111110101111011011111111a11111111101011111111110111
1111111111101111111111011111110101100111111101110111110111011110111110111111111111111111111000110111111111101111111111111011100111111a11111011001011010111111111
1011000111111011111011101111111111001011111110110111111111111111111101011101111111110111101111101001110011011111111101111111011111101a00011111111111111111010110
1101111111010111101011011101101011111011111011010111111111111011111110111111111110111101111110001110111111111111111110101101011111110a10111101001110101111111111
1111010111111111010100111001100111011011110011011111011111111110111111111111111111111010101111101101001111101111111111101111111111010a11111111101111111001110111
0111111110011110111111111011111111111110111011111111101110111010111101110011111101111111011101011110011111110111011010011111111110111a10110101101111111111111111
1111111111101100010011111111111000101111011111101111111111101111111011001111001111011111110111101111111011011110111111011111111111111a11011111111111111111111110
1111011111011111001110101111001111101111111111111010111111101110111011111110111011111111101111111111111011110011100100111111001111011a01110011111010110100100111
