25,10
36,100
18,35
38,51
105,9
121,96
148,78
28,69
111,2
76,78
110111011101011100011111111111111a111111101111010011011111110111111011001a0212b20212000220021220222222220222222122022202b210222222220012121001101111110111111110
100011111101111101111111110111101a110110110011101101111111110101111111111a2011b02222212210212012121220222202212221202120a002212102000212002201011110111111111000
011111111110111111111111110011111a011011111011111110101111101110111101111a2111a12222222020200102202221222022221002022222b022020221221122111212011111111111111110
111111111011111111111010111001100a101111011111110110001011111111111011111a1120a22220222222022221200222022102221211222212b221012122002122210111101111111101110111
112221212200120212211121002102012b201021211210222011001111101101111010111a2211b01020201122222221101202222211202002222222b221112220012021222222110111111001111111
122111122021011212110122021121222a011112202111022111111011110111101011101a1111a02212011220221211222221022022002221220202b220222221022202121110111111100111111111
220201122201120022221112001012121a201121220211121110111111111011010111111a2111b22122222122220212212202201212221020210122b211111022202022000212111111010111111011
201220201002110020011111022211222a222001221112122100001111011111101111111a2001a22202202220212222221020220112212212220220b122022222220021212221011111011110111110
112121202220011010102112100112121b101211222212222001111011110111011111110a0221a11220122222101102222122020212210122010210b020221012211100221202111111110101111011
002121112111212211012101001111110a001222011012211100111111110111011101101a2111b22200222000201121212122202002210121222211a222222212002212211112111111101011001011
221102011022220010112211122220002b120221212021112111111110111011111101110a1122b12002022002122222002022212202122202020222a222122220211222102022101111111111111111
121111021100122022112211021121121a110112212210001001111111111111101111101a0110a21222202221222011220110222221220102220202b022221022211201100111111011111110100100
012210111110121220102022211111211a111120000121122110110111011011111111110a2120b22210222222222222221022202020000011000202b121210222221221021011110111011011101111
001120022212022020112010121100222a212101102121221011011111111110110111101a0022a20010202222221112022102202222222020122220b222110202212011211202100010111111011111
012220002111122012221211122111200b010212111122221011111111111011111111111a2122b21220121222220022100220110122012222221100b012020022220200100222100111111111111001
212120222220121211120010121200211a011202222012222101111101110101111111111a2012b12222221012220121012022122112202100222122b221122121221212212122111010111111011011
202212201202212001111022100212222b220100101212022111111101111011111111101a0102a20222202220202221200222222212202201221222b212222021201202222202110111111111110101
110221120121122201122012221021121b121120221222110100111111110111010101110a0211a22022122202201102122021012002222220222110b212201020222220210122111101111011111101
012102110101112010121001221121001a202001200112212000011111101110101111111a0211a22220022022122222220122202022220222121122b121221202010120011111111110110011110111
122101002112202121012010022101221b011211201011200001111111101110011111101a1221a11121012122221212222221122202222222122120b202201221220121112211010111110110111111
211111120121121222202220212020021b221201200212021120220111211121001011100a0111a02222211221220122211222212222222110202220b020221110221222021200110111101111101111
100111220211212122110210120222202b222022100202020201212202212211110001101a0111a00210002212202211222122201222222221221222b011020222100012201211111011111011110111
211110222201222202201021020211201b220122021212021100121112112202111201111a1121b22022220221212222220022020222122220222202b222022220202121220211111101011011100111
022101122221222022221122022222011a220222212221212210122022211221121221111a0112b22221122022221121122222122122222202200221b202222221222020222222111101111111111111
102122110210222120220220200222002a222202222012212201212222222111122210111a2012a10222210012202202022222220122001202222001a011120212022211210112111101111110001111
200100122210021222220200000222021b212120211012212112221112212122102101111a1212a11201221220102212122102122222220222212220b202122212011220221000111111111111111111
102111102222002022222202111222212b112222120220221212212220212010100111111a1202a22022202112211221222212202222201201222122b121122220212222221221101010100011011111
120110222101222221022021022020012b200022102222102202220201121201222121111a1122a11202221122222101222222222222201222212222a010222012222112112221111111111001111110
111212022012201220222122102012220a020112201221002110101211111202122221010a2111a21200120222202122222121021002002212212001b222222222221220012120111111111001100101
101211022202000202122122020222020b012021212022222002101022120121212221110a1101a22122022120222021110022022122202221120021b222001122122002012222110111111110111111
111200121122222002210220221122022b121221221221201212011220112212022221111a0120b20011202202112222202111212211202012200122b002202221122222220012111111111011111111
011012010201222220202002121112210b201001200220222220122212212110112211111a1212b02222021212022102022220022222020122122020b222122202200020211021111111110111111010
002021012222220122222222222222021a212022220222121012122221221222222211001a0222b22222222022121212020202202122222212221212b202022112212210001211110011011111101001
211021222221202222222222202022220b020020012221212111211212221100121221110a2210b22112112012111002212221211210021211220001a202101102211002111110011111101111100101
101002202021122112212122222021222b222202212202222121001221001100220211110a0201a22202121012112012201202120112110102212101b012211210222120111110011110111111111111
212012102102212220222122021221222b022202022021220110102212112211002120111a1012b22012120201112220211120202020112221122121a112212122212121111101111110111111111101
110122022222012222012222022222022b022220012222200110221011121112100021110a1010a21111121001101021121211111110211002021011b222021112020021100011111101101111111110
122222210012222120221020102212222a112222002022212011111121102101121021101a0222b22122121121212002210112221120210111212202b120220111220111111101111111111111110111
222020202222222222222201222122222b222002222002121222220220101112211111111a2011a10212110021222102111110121201022001001012b222221111000122011111111111111111010111
222122022012022222220212102222221bbbbbaabbbbbbbbabbbbbbababaabaaabaaaaaaaa1120a22101120011210222212111221110211112111111b111022122111010010111011011111110111111
221202222121222220022200212220221222022122212220011102201222021111222111111111a11000100110101101110111010111111111111100a101111111111111000111101110001110001100
222221122222202222022212022022020222220222120202212022201211012222010111111011a11101111111100111011111011111111111101111a111111111011110011111111001111111111111
222212120022200022222220222220222022002221220022012122222122110002012111011011a10111111101101111101111101101111111111111a111111111110101000111111110010001111111
220201122222222220221220100221121201212122222222222222222221020201002100111110a11001111101011110100111011111111111100111a010111110110100101101111110101111111111
220202212220220212202220222022222122210221222202220100002221112221111111111111a11111111110111111110101111111111101111111a111111111111101110101111010111001101111
222222222202222022222222222222210222220022222012220222121212012021202111111111a10111011110111111111111111110110111111111a111111111111101011011101111011111110111
100222220222001122000020220222100222021222022022212122220201221201201111111010a01111101101011110011111011111111100111111a111001111100111111111111111101011111111
222010022021222202201202121222220202202220222212222220011221012000122221121111b12210220112021012012122020100110111010002a120101220211200211221210222222101101220
122220220201222201212222022222220220222122222222222020221202222122202111202110b02110202222021121201020110121111110101222a221212200121212022101211012222022021221
212212202220212222002222222220222212220222202222222222202121221120222111221200a12212202110012101010211021211001010011202b120012212111220222101101201111110112222
202221122022202220120220020020222202210212221221022222222222222012222110201121a01221221212102102010212012221111101111211a111101210220120011012002121012220122022
102200221200012221102102222212020222222220222220222212022222222222212002112011b22012112012100122011222012111011011111211b111222212122010122010011022202111210222
220100221222222222202000020022022202002002220222212222201222212221022012111122a12011221001212022101122022121111111111021a212110210011211021002012120111202021221
022201110222222202222202002120122202222202202022222202220112201211021111102221a10202212111200021021121012100011111111001a102021220221121110012101221122111211110
200122122202200222122222222122222202222222022202222112022222120122200102211112b11110121010121111122012011120111101111210a201212111210010222222122200121121011212
220101222020220220222222220022202021012202222202222222222220222122022222102012a20102211111111221111210220221101111101021a022202201021122122221121110021020221221
112222202202222122202222200121002222222212121220221122221212202212122022211000b11212021121112200022210022011111011111101b120112122122122120201221011102012022222
002222222022111201022221202222100221222222222222222002202002022210022111101111a10002012212121121110102112010111111111211b021112102220011011010100011122121210102
210222220222220021202202220121122022220021200110022212221121122202222011212122b11111111112220112022011212111111111111201b101212111121112212222111121220220112102
012212222222020222202202022021222002220020122222222222222220000212120210122222a20111221211201210221010222121111101110101b100121222001222211221021101112121101112
221122102202222021220222222202222122002202212222222022021222020220011111022220b11222221220102021101020220221101111011112b110111011101211222022212212021211111220
211001220122222222221222121202212220022212222220222222222220222202222201101222a21111121001212112012120121111111000111122b112112002221112212212112122112211122022
220212022222202222222022222200022100012102212022002220012222210212220212222112a00021211012212212021211212211111101111011a102211112201120220200212221222120211211
210220222001212212222012222221220222010220102222222222122202022200021111021112b10210120012010202020220211121110111111120a211021012021212211112121101110211121121
002021200220211020022222200022222222220222201122002212022222002202022210222121a12210121201122221101222212001101111010220bbbabaaaaaaaaabbbbabbaaabbabaaabababaaaa
012102222010222222202022221202222002222022222220222221022222220122221122212012a122122112222020122112122121111122120100222211121220021101202012220122222210100021
122222002222112022220102012022212112200200120222022222222222102020202211121222b200012212122100002022222222112222021222220222010212212221202102222222011011121122
210121202220220002210221201222221222222122022010222220222212020201011202121200a202222012210222202200202221111211121211211022222221020221200222222212021020120101
201010222022022102012210222220222221221222121222222222222122222222002222111221a211121222122212022220012002211010021111022211211100221022122202221120222211102212
010022022202220122111121212201022220010000112222211222222220021122012121011111b120222201220222222122221222221212101210022221222212102021220122222121200112101002
110101101102222220012012211222002222202022222202222222020220222200121112211212a011212201121211202210210212010221112122222222122122201122221122102022211021201101
202122002011021222221021022222022222020012211221210210102122222121222102211112b122220012010221011122112221201121221200020201222222122222212020121220220122112111
021202111222222212011222022021122221221002202222222022221021021122122202122210a110212102012220221122101002200121112022222221112201102222022022122212211012201121
120120221201221012222222220022122221121120012222222222022222222222221220210222b120202101211122000212022201220202011110112002221222020212012202200202212220102110
110100022221202012222110021220222212222222002121102222002222222220022121112121a120222211121022202212222212202010011212222101220221022222122002222102222221220111
021112010220022221222112022222222222022222210000222220222222022101102222022120a002000121220111220200221220111112002212121102212111222002221022101222200211102220
200202220102022211202021120222221202222222012222222222212102022201212112011022b201122022112222212220220000021201012010202212022201202222221122020122001212112222
111222110222222122122122020022220212010220212022200222112022222022212010222211a022122222212012020112220222212012010102212200221012220122221220202202022211112102
100121202222122222112222222202122222221221222222022122102202201212202222112211a022212121222101021222120200200020112112100212210121221221002021111221221011022110
112200122202120220002020201020221222222212221120122222222021220112122111022222baababaabaabbbabbbbbbabbbabbbbaabbbbbbbbbaaaababbbabbbbbabbbb022220020022012202121
212010022222222201022102022112200022200211122120022222102002222221221210111010120111210011020222220120222021110200012202221112022022022221b220021022220222221112
201121020202202222112022012121222022220200202222220222222221220020202100110002100110012101022220022222011221121011022220211002121022020022b221221222120122012201
100012021221011201001210010111120111110221211222222222122221212021122012120102012100111112222121002220201002202102110002222010212022220221b202222222022221011000
221112221122112112022220221121021111222111212222222222222022221111102221001111012011110212221122012211220020022211221222021210222012022222a212021202010220220200
111201121202212122121212210122220111211121201120211212122202211101111220202110221211010101210020202200121021100120211110122222220121102202b120222222222220022211
101212011022021212122120011102002122211222010002120222201122102111110012211021221120222011211010020222222221101112120222122212111221022122b220222112222021120222
222121011020110121200210100101211211112111100122210122122022211220121111122112111121120001012212211222210211121001200202222001222102222021a101202212212211111110
011102202120202120121212020201120222112122010101202202220021121022211211121101112100221101222122110222202120211002212022122210222022222222a122012202210220221021
111022012101022210102221201202211122211120110201102222220210220102221122022121112022212111122002222112202222221211102220122220022120200101b211022200202222012211
211222211002012121110112101222021202022110112120121022202221121221201000121222111220121121120222222020122222110210112220022122021122222220b122222022022211221022
002121211221002222111210222022121120211102200222022202022102121212210012121212111212112102202200120210220102222222121002201021212222122122b012222222222201101222
121211112202020121120200011202221012111012201122212202211101002021011111120020110021200200222212220202222200112112112110221120222220210222b222222012021202012102
221211211222020212121120110122212121021112220201212212122120022122011021022112112221122001222112201220222220120100201221212122102002222012a022122022201021210102
111001020102121112202212112100221222222200212012120212122220201122101122222200121222102111202112220220222121212021112202002222212102121200b211200012202212212210
022220022111011022122000110210201021212021201200221222021222202022012101112222110102222221122100122022121220111211101120022222202211002102b002210221221022212222
111020221210212111201121110110111020122202001222222221222200112111011122221110022122022211221122202002222022102112212222202200200202221112b201001200220122022012
012222121110101211210110111120211102212201211212022100221211221112021022221012120002011122021202002222210121120220101220202020210222220012b212202011220022020222
112111221212201121212222112102222202010112021022212122212201102000001212010220210112111210222102211111222221021201210222220020221222212021b212022220220100111012
111112222220110220112112201011102122011001012011222202222221201210212221102201211012212112212221022101201201210212020022200212112222222212a000222122222222221101
221102111212221222200121211000212212012222222112220220222221120022222122111202001211222220220222122022122212020012101100222222212220201122abbbbbabbbbabbabbabbb1
aaaaaaaaaaaaaaaaaaaaaaaaaaaaaaaaaaaaaaaaaaaaaababbabbabbbbabaaaaabababbaaabbbbaabbabbbbbaabbbbbbb2222221221021011110022022222010222022220222222222122200211212a2
111111111101110110111110111110111011101011011221122012211112221211211111111122120222111012222102a1202222102212121222210221212221220202022222212022022202100100b1
111111100111111111011111010011111101111011111100202221100110211212012222222222120221202122120020b0122202222122221111110120202211122222120000100022111120221112b1
111111101111011111010101111111111111011101110211201010022012121102112110210220122111201221022021b2220222222110022022122222111220222220202222122122022201201010b1
011011101111110111110101111111011111111111111101020021200211200112112211221112211221211120202020b1012020122112001211022202022212220022222002220200220222121112a2
110111111101011010101111111011111101111111100112212022212012201202221011201021020121222011212202b2100121220122002200212221202200202222022222102212201220111221b2
110111110111110111110101101110010111101011011211212022212221011121222120222222100210012121212222b1121200222022222222022221222020012002020020222201200221011221b1
111111111101111111111011111101010111111111100222211000200222120222212220212221210101011201202221b2221020222202121121022222220212020202220221222222020000122110b1
111111111000101111111111001101101110111110101122021021002000101110221211201221222210102112222222b2102022022002011122202210222222212220200222221221212110221112a1
111111110111111010110111011111010110111111000111111111011111011111111111011101111000111101011102b2222111121111212221121212001121212121000120110011021112111111a1
110110110001111111011111000111110101111111110111001111001111111101011100111110111001111110112111a1110110221122112001102021222121120221020112102112100120111011a0
111101111111011010111111111111011111010001111011101110101101111111111111011111111011110110222222a2020121121111221022211201020121202121010222212212102202111111a0
011101100111011111111111111100101011011111111111111111110111110100111111011111111111111111220211b1111011022201212222112122020011021121100001011220002001111101a1
101111101110111110101111111001111011111101111011110111111111111111010111101111010011111111101120b2200021112021202120022211020222020101122200122102221222101111a0
111111111111111111011110011111111011011011110011111111001111101101111101111111110111101111222101b2111100012120210120122001121012111122020111121212221211011110a1
111011111101111111111111010011111111111010111110111111110110110110001111111111011111111111002211b1222012102212212110022012002012202110211210021021212010111111a1
101111100011111111111011111011110001011111110101001101111110111110111101110110011010011111212222a1111220222212011120121111220120111121221111121200211102111111a1
100111111101111110111111111111111111111011100111111110111111111111111111111001111110111110211222a2101212200102010102020001222212220221021222221020121021100111a1
101010001111101111111111100001110011101110110111111111011011111111110011111111111011101101100200b2212221020002111121221111001110212121112111111201100212010101a1
011111100110111111011011011011111111001111111111111011101011111001111111111011111111110111111122b0112012202101122122102012112001111012211111102100112012101101a1
